üblich – usual
der Scheinwerfer - spotlight
sogleich - immediately
auffielen - to stand out
die Bügelfalten - crease
obschon - although
das Schneetreiben - blowing snow
kaum - barely
das Fahrgestell - chassis
der Schimmer - shimmer
die Tragfläche - wing
rutschen - slide, slip
die Geste - gesture
das Sieb - strainer
plumpsen - splash
die Knarre - rattle
brüllen - shout, roar
die Weile - while
neuerdings - recently
das Rudel - horde
voran - ahead
scheppern - to clank
hallen - to echo
schwindlig - dizzy
schwitzen - to sweat
verstecken - to hide
der Donner - thunder
reiben - to rub
die Blässe - paleness
pfeifen - to whistle
irgendein - some
betreffend - concerning
verschoben - to postpone
fassen - to grab
allerlei - all sorts
die Ausrede - excuse
anschnallen - to strap on
ausklinken - to release
geradezu - almost
behaupten - to assert
sogar - even
das Staatsgebiet - national territory
einig - agreed
kühn - bold, brave
vernünftig - sensible
falten - to fold
die Mühe - trouble
offenbar - obvious
senkrecht - vertical
der Schatten - shadow
der Kiesel - pebble