allerlei - all sorts
am Zug sein - it's one's turn
anschnallen - to strap on
auffielen - to stand out
ausklinken - to release
befürchten - to fear
behaupten - to assert
betreffend - concerning
beziehungsweise - respectively, or
bloß - bare, only
brüllen - shout, roar
das Fahrgestell - chassis
das Gespenst - ghost
das Hitze - heat
das Jenseits - beyond
das Rudel - horde
das Schneetreiben - blowing snow
das Sieb - strainer
das Staatsgebiet - national territory
das Tal - valley
das Totenreich - kindgom of the dead
der Aufenthalt - stay
der Ausfall - failure, cancellation
der Donner - thunder
der Dunst - haze
der Hafen - port, dock
der Kiesel - pebble
der Laie - the laymen
der Pneu - tyre
der Schatten - shadow
der Scheinwerfer - spotlight
der Schimmer - shimmer
der Stoß - punch, kick, blow
der Sturz - fall, accident
der Sumpf - swamp, marsh
der Vortrag - lecture
der Zufall - chance, coincidence
der Ärmel - sleeve
die Anweisung - instruction
die Ausrede - excuse
die Blässe - paleness
die Bö - gust, squall
die Bügelfalten - crease
die Eidechse - lizard
die Faust - fist
die Geste - gesture
die Glut - ember, ash, heat
die Knarre - rattle
die Mühe - trouble
die Sinflut - flood
die Spur - trace, track
die Tinte - ink
die Tragfläche - wing
die Weile - while
dreckig - filthy
eben - flat, even, just, precisely
ein Affenschwein haben - to have luck
einheimisch - native
einig - agreed
eintreten - to enter
entschließen - to make up one's mind
erklärlich - understandable
errechenbar - calculable
falten - to fold
fassen - to grab
fetzen - to tear
flimmern - to flicker
flitzen - to shoot, to dart
geradezu - almost, direct, blunt
günsting - favorable
hallen - to echo
irgendein - some
kaum - barely
keinesweg - by no means
kippen - to tilt, to tip
kühn - bold, brave
lediglich - only, merely
neuerdings - recently
obschon - although
offenbar - obvious
pfeifen - to whistle
plumpsen - splash
reglos - motionless
reiben - to rub
rieseln - to trickle
ringsum - all around
rutschen - to slide, to slip
sacken - to plummet
sausen - to whistle
scheppern - to clank
schlottern - to shiver, to shiver
schwindlig - dizzy
schwitzen - to sweat
senkrecht - vertical
soeben - just
sogar - even
sogleich - immediately
spüren - to sense, to feel
starr - stiff
stauen - to marvel
staunen - to be amazed
stumm - wordless, silent
unhöflich - impolite
unvermeidlich - unavoidable
vernünftig - sensible
verschoben - to postpone
verstecken - to hide
verstummen - to go silent
vollkommen - perfectly
voran - ahead
vorder - front
vorläufig - temporary
wackeln - wobble
weigern - to refuse
widerlich - repulsive
wippen - to bob up and down
zucken - to twitch, to jerk
üblich - usual
übrigens - by the way